"지역","발생횟수","날짜","year","month","비품종견","품종견"
"서울",356,"2016-01-01",2016,1,133,223
"부산",248,"2016-01-01",2016,1,146,102
"대구",141,"2016-01-01",2016,1,78,63
"인천",221,"2016-01-01",2016,1,108,113
"광주",104,"2016-01-01",2016,1,60,44
"대전",232,"2016-01-01",2016,1,64,168
"울산",85,"2016-01-01",2016,1,52,33
"세종",11,"2016-01-01",2016,1,7,4
"경기",1074,"2016-01-01",2016,1,619,455
"강원",226,"2016-01-01",2016,1,137,89
"충북",209,"2016-01-01",2016,1,84,125
"충남",166,"2016-01-01",2016,1,107,59
"전북",176,"2016-01-01",2016,1,107,69
"전남",158,"2016-01-01",2016,1,103,55
"경북",233,"2016-01-01",2016,1,162,71
"경남",400,"2016-01-01",2016,1,290,110
"제주",150,"2016-01-01",2016,1,114,36
"서울",375,"2016-02-01",2016,2,145,230
"부산",256,"2016-02-01",2016,2,138,118
"대구",139,"2016-02-01",2016,2,86,53
"인천",252,"2016-02-01",2016,2,119,133
"광주",108,"2016-02-01",2016,2,68,40
"대전",196,"2016-02-01",2016,2,75,121
"울산",100,"2016-02-01",2016,2,56,44
"세종",10,"2016-02-01",2016,2,2,8
"경기",1008,"2016-02-01",2016,2,547,461
"강원",228,"2016-02-01",2016,2,140,88
"충북",224,"2016-02-01",2016,2,110,114
"충남",184,"2016-02-01",2016,2,122,62
"전북",184,"2016-02-01",2016,2,114,70
"전남",168,"2016-02-01",2016,2,96,72
"경북",264,"2016-02-01",2016,2,192,72
"경남",420,"2016-02-01",2016,2,302,118
"제주",215,"2016-02-01",2016,2,175,40
"서울",455,"2016-03-01",2016,3,178,277
"부산",289,"2016-03-01",2016,3,180,109
"대구",201,"2016-03-01",2016,3,114,87
"인천",265,"2016-03-01",2016,3,104,161
"광주",111,"2016-03-01",2016,3,57,54
"대전",201,"2016-03-01",2016,3,70,131
"울산",120,"2016-03-01",2016,3,71,49
"세종",18,"2016-03-01",2016,3,7,11
"경기",1233,"2016-03-01",2016,3,652,581
"강원",269,"2016-03-01",2016,3,162,107
"충북",208,"2016-03-01",2016,3,96,112
"충남",311,"2016-03-01",2016,3,186,125
"전북",250,"2016-03-01",2016,3,142,108
"전남",223,"2016-03-01",2016,3,144,79
"경북",268,"2016-03-01",2016,3,174,94
"경남",457,"2016-03-01",2016,3,320,137
"제주",155,"2016-03-01",2016,3,108,47
"서울",544,"2016-04-01",2016,4,181,363
"부산",304,"2016-04-01",2016,4,170,134
"대구",176,"2016-04-01",2016,4,93,83
"인천",315,"2016-04-01",2016,4,136,179
"광주",116,"2016-04-01",2016,4,45,71
"대전",169,"2016-04-01",2016,4,60,109
"울산",126,"2016-04-01",2016,4,48,78
"세종",17,"2016-04-01",2016,4,6,11
"경기",1228,"2016-04-01",2016,4,612,616
"강원",273,"2016-04-01",2016,4,166,107
"충북",208,"2016-04-01",2016,4,90,118
"충남",257,"2016-04-01",2016,4,151,106
"전북",254,"2016-04-01",2016,4,142,112
"전남",203,"2016-04-01",2016,4,113,90
"경북",268,"2016-04-01",2016,4,183,85
"경남",453,"2016-04-01",2016,4,321,132
"제주",171,"2016-04-01",2016,4,130,41
"서울",535,"2016-05-01",2016,5,174,361
"부산",271,"2016-05-01",2016,5,146,125
"대구",196,"2016-05-01",2016,5,97,99
"인천",336,"2016-05-01",2016,5,132,204
"광주",153,"2016-05-01",2016,5,64,89
"대전",158,"2016-05-01",2016,5,67,91
"울산",120,"2016-05-01",2016,5,53,67
"세종",19,"2016-05-01",2016,5,9,10
"경기",1331,"2016-05-01",2016,5,648,683
"강원",255,"2016-05-01",2016,5,150,105
"충북",229,"2016-05-01",2016,5,97,132
"충남",263,"2016-05-01",2016,5,154,109
"전북",232,"2016-05-01",2016,5,112,120
"전남",210,"2016-05-01",2016,5,108,102
"경북",312,"2016-05-01",2016,5,220,92
"경남",504,"2016-05-01",2016,5,357,147
"제주",180,"2016-05-01",2016,5,126,54
"서울",517,"2016-06-01",2016,6,158,359
"부산",306,"2016-06-01",2016,6,162,144
"대구",184,"2016-06-01",2016,6,78,106
"인천",319,"2016-06-01",2016,6,119,200
"광주",166,"2016-06-01",2016,6,77,89
"대전",246,"2016-06-01",2016,6,62,184
"울산",145,"2016-06-01",2016,6,65,80
"세종",12,"2016-06-01",2016,6,4,8
"경기",1212,"2016-06-01",2016,6,522,690
"강원",282,"2016-06-01",2016,6,165,117
"충북",211,"2016-06-01",2016,6,96,115
"충남",274,"2016-06-01",2016,6,162,112
"전북",287,"2016-06-01",2016,6,159,128
"전남",187,"2016-06-01",2016,6,104,83
"경북",243,"2016-06-01",2016,6,159,84
"경남",544,"2016-06-01",2016,6,378,166
"제주",199,"2016-06-01",2016,6,162,37
"서울",569,"2016-07-01",2016,7,181,388
"부산",316,"2016-07-01",2016,7,158,158
"대구",203,"2016-07-01",2016,7,90,113
"인천",324,"2016-07-01",2016,7,107,217
"광주",181,"2016-07-01",2016,7,73,108
"대전",240,"2016-07-01",2016,7,76,164
"울산",127,"2016-07-01",2016,7,56,71
"세종",23,"2016-07-01",2016,7,7,16
"경기",1578,"2016-07-01",2016,7,684,894
"강원",312,"2016-07-01",2016,7,164,148
"충북",247,"2016-07-01",2016,7,91,156
"충남",256,"2016-07-01",2016,7,149,107
"전북",300,"2016-07-01",2016,7,157,143
"전남",221,"2016-07-01",2016,7,128,93
"경북",269,"2016-07-01",2016,7,145,124
"경남",561,"2016-07-01",2016,7,377,184
"제주",181,"2016-07-01",2016,7,148,33
"서울",611,"2016-08-01",2016,8,208,403
"부산",336,"2016-08-01",2016,8,188,148
"대구",225,"2016-08-01",2016,8,107,118
"인천",331,"2016-08-01",2016,8,109,222
"광주",149,"2016-08-01",2016,8,68,81
"대전",229,"2016-08-01",2016,8,70,159
"울산",180,"2016-08-01",2016,8,92,88
"세종",24,"2016-08-01",2016,8,18,6
"경기",1479,"2016-08-01",2016,8,673,806
"강원",422,"2016-08-01",2016,8,243,179
"충북",285,"2016-08-01",2016,8,150,135
"충남",296,"2016-08-01",2016,8,183,113
"전북",330,"2016-08-01",2016,8,176,154
"전남",285,"2016-08-01",2016,8,177,108
"경북",315,"2016-08-01",2016,8,201,114
"경남",601,"2016-08-01",2016,8,418,183
"제주",244,"2016-08-01",2016,8,198,46
"서울",581,"2016-09-01",2016,9,163,418
"부산",357,"2016-09-01",2016,9,204,153
"대구",223,"2016-09-01",2016,9,105,118
"인천",305,"2016-09-01",2016,9,115,190
"광주",156,"2016-09-01",2016,9,62,94
"대전",215,"2016-09-01",2016,9,79,136
"울산",153,"2016-09-01",2016,9,74,79
"세종",24,"2016-09-01",2016,9,10,14
"경기",1422,"2016-09-01",2016,9,675,747
"강원",291,"2016-09-01",2016,9,154,137
"충북",236,"2016-09-01",2016,9,121,115
"충남",298,"2016-09-01",2016,9,174,124
"전북",272,"2016-09-01",2016,9,151,121
"전남",261,"2016-09-01",2016,9,159,102
"경북",319,"2016-09-01",2016,9,212,107
"경남",613,"2016-09-01",2016,9,428,185
"제주",215,"2016-09-01",2016,9,171,44
"서울",517,"2016-10-01",2016,10,181,336
"부산",317,"2016-10-01",2016,10,160,157
"대구",216,"2016-10-01",2016,10,115,101
"인천",283,"2016-10-01",2016,10,108,175
"광주",161,"2016-10-01",2016,10,65,96
"대전",221,"2016-10-01",2016,10,74,147
"울산",157,"2016-10-01",2016,10,86,71
"세종",24,"2016-10-01",2016,10,9,15
"경기",1311,"2016-10-01",2016,10,595,716
"강원",321,"2016-10-01",2016,10,200,121
"충북",239,"2016-10-01",2016,10,116,123
"충남",339,"2016-10-01",2016,10,220,119
"전북",325,"2016-10-01",2016,10,183,142
"전남",218,"2016-10-01",2016,10,124,94
"경북",310,"2016-10-01",2016,10,217,93
"경남",544,"2016-10-01",2016,10,378,166
"제주",200,"2016-10-01",2016,10,162,38
"서울",457,"2016-11-01",2016,11,179,278
"부산",309,"2016-11-01",2016,11,159,150
"대구",159,"2016-11-01",2016,11,79,80
"인천",266,"2016-11-01",2016,11,111,155
"광주",123,"2016-11-01",2016,11,48,75
"대전",211,"2016-11-01",2016,11,79,132
"울산",142,"2016-11-01",2016,11,81,61
"세종",17,"2016-11-01",2016,11,6,11
"경기",1146,"2016-11-01",2016,11,580,566
"강원",302,"2016-11-01",2016,11,185,117
"충북",233,"2016-11-01",2016,11,102,131
"충남",236,"2016-11-01",2016,11,148,88
"전북",205,"2016-11-01",2016,11,108,97
"전남",203,"2016-11-01",2016,11,132,71
"경북",229,"2016-11-01",2016,11,157,72
"경남",503,"2016-11-01",2016,11,342,161
"제주",235,"2016-11-01",2016,11,187,48
"서울",351,"2016-12-01",2016,12,137,214
"부산",267,"2016-12-01",2016,12,151,116
"대구",152,"2016-12-01",2016,12,84,68
"인천",203,"2016-12-01",2016,12,79,124
"광주",136,"2016-12-01",2016,12,58,78
"대전",176,"2016-12-01",2016,12,58,118
"울산",131,"2016-12-01",2016,12,68,63
"세종",22,"2016-12-01",2016,12,15,7
"경기",1120,"2016-12-01",2016,12,567,553
"강원",239,"2016-12-01",2016,12,151,88
"충북",201,"2016-12-01",2016,12,104,97
"충남",259,"2016-12-01",2016,12,177,82
"전북",216,"2016-12-01",2016,12,136,80
"전남",154,"2016-12-01",2016,12,90,64
"경북",274,"2016-12-01",2016,12,209,65
"경남",472,"2016-12-01",2016,12,337,135
"제주",219,"2016-12-01",2016,12,169,50
"서울",372,"2017-01-01",2017,1,171,201
"부산",219,"2017-01-01",2017,1,108,111
"대구",145,"2017-01-01",2017,1,86,59
"인천",258,"2017-01-01",2017,1,125,133
"광주",109,"2017-01-01",2017,1,37,72
"대전",181,"2017-01-01",2017,1,68,113
"울산",113,"2017-01-01",2017,1,73,40
"세종",17,"2017-01-01",2017,1,8,9
"경기",1053,"2017-01-01",2017,1,572,481
"강원",230,"2017-01-01",2017,1,127,103
"충북",213,"2017-01-01",2017,1,123,90
"충남",306,"2017-01-01",2017,1,220,86
"전북",215,"2017-01-01",2017,1,121,94
"전남",177,"2017-01-01",2017,1,117,60
"경북",247,"2017-01-01",2017,1,161,86
"경남",434,"2017-01-01",2017,1,312,122
"제주",267,"2017-01-01",2017,1,220,47
"서울",327,"2017-02-01",2017,2,122,205
"부산",251,"2017-02-01",2017,2,146,105
"대구",151,"2017-02-01",2017,2,95,56
"인천",220,"2017-02-01",2017,2,113,107
"광주",115,"2017-02-01",2017,2,44,71
"대전",152,"2017-02-01",2017,2,53,99
"울산",113,"2017-02-01",2017,2,56,57
"세종",20,"2017-02-01",2017,2,5,15
"경기",980,"2017-02-01",2017,2,562,418
"강원",306,"2017-02-01",2017,2,207,99
"충북",165,"2017-02-01",2017,2,103,62
"충남",270,"2017-02-01",2017,2,162,108
"전북",240,"2017-02-01",2017,2,141,99
"전남",160,"2017-02-01",2017,2,95,65
"경북",256,"2017-02-01",2017,2,175,81
"경남",434,"2017-02-01",2017,2,322,112
"제주",222,"2017-02-01",2017,2,172,50
"서울",443,"2017-03-01",2017,3,182,261
"부산",292,"2017-03-01",2017,3,172,120
"대구",174,"2017-03-01",2017,3,85,89
"인천",310,"2017-03-01",2017,3,145,165
"광주",129,"2017-03-01",2017,3,55,74
"대전",215,"2017-03-01",2017,3,82,133
"울산",135,"2017-03-01",2017,3,78,57
"세종",14,"2017-03-01",2017,3,9,5
"경기",1252,"2017-03-01",2017,3,656,596
"강원",278,"2017-03-01",2017,3,180,98
"충북",261,"2017-03-01",2017,3,147,114
"충남",339,"2017-03-01",2017,3,203,136
"전북",282,"2017-03-01",2017,3,176,106
"전남",212,"2017-03-01",2017,3,123,89
"경북",267,"2017-03-01",2017,3,186,81
"경남",577,"2017-03-01",2017,3,441,136
"제주",301,"2017-03-01",2017,3,255,46
"서울",477,"2017-04-01",2017,4,165,312
"부산",301,"2017-04-01",2017,4,165,136
"대구",188,"2017-04-01",2017,4,79,109
"인천",334,"2017-04-01",2017,4,118,216
"광주",147,"2017-04-01",2017,4,62,85
"대전",210,"2017-04-01",2017,4,58,152
"울산",152,"2017-04-01",2017,4,80,72
"세종",14,"2017-04-01",2017,4,6,8
"경기",1310,"2017-04-01",2017,4,664,646
"강원",316,"2017-04-01",2017,4,180,136
"충북",249,"2017-04-01",2017,4,134,115
"충남",290,"2017-04-01",2017,4,173,117
"전북",292,"2017-04-01",2017,4,164,128
"전남",230,"2017-04-01",2017,4,142,88
"경북",303,"2017-04-01",2017,4,225,78
"경남",559,"2017-04-01",2017,4,406,153
"제주",251,"2017-04-01",2017,4,211,40
"서울",512,"2017-05-01",2017,5,158,354
"부산",376,"2017-05-01",2017,5,208,168
"대구",206,"2017-05-01",2017,5,93,113
"인천",372,"2017-05-01",2017,5,136,236
"광주",158,"2017-05-01",2017,5,68,90
"대전",263,"2017-05-01",2017,5,61,202
"울산",123,"2017-05-01",2017,5,52,71
"세종",11,"2017-05-01",2017,5,5,6
"경기",1345,"2017-05-01",2017,5,599,746
"강원",365,"2017-05-01",2017,5,238,127
"충북",231,"2017-05-01",2017,5,105,126
"충남",339,"2017-05-01",2017,5,219,120
"전북",298,"2017-05-01",2017,5,182,116
"전남",227,"2017-05-01",2017,5,137,90
"경북",324,"2017-05-01",2017,5,226,98
"경남",575,"2017-05-01",2017,5,399,176
"제주",380,"2017-05-01",2017,5,318,62
"서울",492,"2017-06-01",2017,6,163,329
"부산",371,"2017-06-01",2017,6,220,151
"대구",225,"2017-06-01",2017,6,110,115
"인천",325,"2017-06-01",2017,6,138,187
"광주",128,"2017-06-01",2017,6,45,83
"대전",234,"2017-06-01",2017,6,79,155
"울산",121,"2017-06-01",2017,6,55,66
"세종",25,"2017-06-01",2017,6,13,12
"경기",1391,"2017-06-01",2017,6,660,731
"강원",356,"2017-06-01",2017,6,231,125
"충북",174,"2017-06-01",2017,6,93,81
"충남",282,"2017-06-01",2017,6,176,106
"전북",312,"2017-06-01",2017,6,178,134
"전남",268,"2017-06-01",2017,6,154,114
"경북",362,"2017-06-01",2017,6,243,119
"경남",556,"2017-06-01",2017,6,386,170
"제주",378,"2017-06-01",2017,6,332,46
"서울",632,"2017-07-01",2017,7,226,406
"부산",389,"2017-07-01",2017,7,220,169
"대구",198,"2017-07-01",2017,7,114,84
"인천",428,"2017-07-01",2017,7,162,266
"광주",183,"2017-07-01",2017,7,96,87
"대전",288,"2017-07-01",2017,7,93,195
"울산",194,"2017-07-01",2017,7,110,84
"세종",20,"2017-07-01",2017,7,16,4
"경기",1852,"2017-07-01",2017,7,918,934
"강원",450,"2017-07-01",2017,7,280,170
"충북",284,"2017-07-01",2017,7,132,152
"충남",451,"2017-07-01",2017,7,299,152
"전북",361,"2017-07-01",2017,7,218,143
"전남",353,"2017-07-01",2017,7,211,142
"경북",373,"2017-07-01",2017,7,232,141
"경남",684,"2017-07-01",2017,7,489,195
"제주",404,"2017-07-01",2017,7,345,59
"서울",568,"2017-08-01",2017,8,194,374
"부산",405,"2017-08-01",2017,8,212,193
"대구",222,"2017-08-01",2017,8,134,88
"인천",408,"2017-08-01",2017,8,170,238
"광주",207,"2017-08-01",2017,8,97,110
"대전",326,"2017-08-01",2017,8,99,227
"울산",162,"2017-08-01",2017,8,86,76
"세종",20,"2017-08-01",2017,8,7,13
"경기",2003,"2017-08-01",2017,8,1001,1002
"강원",492,"2017-08-01",2017,8,311,181
"충북",304,"2017-08-01",2017,8,166,138
"충남",433,"2017-08-01",2017,8,284,149
"전북",444,"2017-08-01",2017,8,277,167
"전남",331,"2017-08-01",2017,8,220,111
"경북",497,"2017-08-01",2017,8,367,130
"경남",825,"2017-08-01",2017,8,584,241
"제주",486,"2017-08-01",2017,8,430,56
"서울",540,"2017-09-01",2017,9,186,354
"부산",385,"2017-09-01",2017,9,200,185
"대구",227,"2017-09-01",2017,9,118,109
"인천",378,"2017-09-01",2017,9,157,221
"광주",161,"2017-09-01",2017,9,76,85
"대전",308,"2017-09-01",2017,9,84,224
"울산",125,"2017-09-01",2017,9,66,59
"세종",16,"2017-09-01",2017,9,9,7
"경기",1645,"2017-09-01",2017,9,844,801
"강원",365,"2017-09-01",2017,9,213,152
"충북",262,"2017-09-01",2017,9,129,133
"충남",349,"2017-09-01",2017,9,242,107
"전북",345,"2017-09-01",2017,9,215,130
"전남",285,"2017-09-01",2017,9,161,124
"경북",384,"2017-09-01",2017,9,272,112
"경남",683,"2017-09-01",2017,9,493,190
"제주",446,"2017-09-01",2017,9,388,58
"서울",464,"2017-10-01",2017,10,186,278
"부산",359,"2017-10-01",2017,10,196,163
"대구",214,"2017-10-01",2017,10,117,97
"인천",359,"2017-10-01",2017,10,134,225
"광주",181,"2017-10-01",2017,10,112,69
"대전",285,"2017-10-01",2017,10,76,209
"울산",142,"2017-10-01",2017,10,69,73
"세종",19,"2017-10-01",2017,10,7,12
"경기",1462,"2017-10-01",2017,10,760,702
"강원",318,"2017-10-01",2017,10,204,114
"충북",252,"2017-10-01",2017,10,129,123
"충남",316,"2017-10-01",2017,10,200,116
"전북",381,"2017-10-01",2017,10,243,138
"전남",302,"2017-10-01",2017,10,201,101
"경북",434,"2017-10-01",2017,10,330,104
"경남",644,"2017-10-01",2017,10,461,183
"제주",437,"2017-10-01",2017,10,374,63
"서울",389,"2017-11-01",2017,11,143,246
"부산",354,"2017-11-01",2017,11,211,143
"대구",217,"2017-11-01",2017,11,115,102
"인천",292,"2017-11-01",2017,11,131,161
"광주",134,"2017-11-01",2017,11,57,77
"대전",259,"2017-11-01",2017,11,74,185
"울산",116,"2017-11-01",2017,11,66,50
"세종",18,"2017-11-01",2017,11,9,9
"경기",1434,"2017-11-01",2017,11,753,681
"강원",314,"2017-11-01",2017,11,206,108
"충북",210,"2017-11-01",2017,11,117,93
"충남",371,"2017-11-01",2017,11,286,85
"전북",267,"2017-11-01",2017,11,177,90
"전남",321,"2017-11-01",2017,11,200,121
"경북",389,"2017-11-01",2017,11,296,93
"경남",656,"2017-11-01",2017,11,503,153
"제주",451,"2017-11-01",2017,11,409,42
"서울",363,"2017-12-01",2017,12,136,227
"부산",291,"2017-12-01",2017,12,151,140
"대구",178,"2017-12-01",2017,12,100,78
"인천",260,"2017-12-01",2017,12,125,135
"광주",116,"2017-12-01",2017,12,51,65
"대전",254,"2017-12-01",2017,12,61,193
"울산",106,"2017-12-01",2017,12,61,45
"세종",20,"2017-12-01",2017,12,6,14
"경기",1225,"2017-12-01",2017,12,696,529
"강원",254,"2017-12-01",2017,12,163,91
"충북",242,"2017-12-01",2017,12,149,93
"충남",391,"2017-12-01",2017,12,294,97
"전북",232,"2017-12-01",2017,12,161,71
"전남",244,"2017-12-01",2017,12,158,86
"경북",355,"2017-12-01",2017,12,263,92
"경남",566,"2017-12-01",2017,12,437,129
"제주",482,"2017-12-01",2017,12,453,29
"서울",400,"2018-01-01",2018,1,172,228
"부산",283,"2018-01-01",2018,1,155,128
"대구",160,"2018-01-01",2018,1,87,73
"인천",280,"2018-01-01",2018,1,152,128
"광주",132,"2018-01-01",2018,1,69,63
"대전",214,"2018-01-01",2018,1,93,121
"울산",127,"2018-01-01",2018,1,71,56
"세종",25,"2018-01-01",2018,1,15,10
"경기",1476,"2018-01-01",2018,1,875,601
"강원",312,"2018-01-01",2018,1,200,112
"충북",251,"2018-01-01",2018,1,166,85
"충남",358,"2018-01-01",2018,1,256,102
"전북",279,"2018-01-01",2018,1,182,97
"전남",337,"2018-01-01",2018,1,227,110
"경북",500,"2018-01-01",2018,1,382,118
"경남",785,"2018-01-01",2018,1,601,184
"제주",474,"2018-01-01",2018,1,422,52
"서울",328,"2018-02-01",2018,2,140,188
"부산",303,"2018-02-01",2018,2,184,119
"대구",200,"2018-02-01",2018,2,90,110
"인천",277,"2018-02-01",2018,2,139,138
"광주",135,"2018-02-01",2018,2,69,66
"대전",240,"2018-02-01",2018,2,77,163
"울산",83,"2018-02-01",2018,2,35,48
"세종",7,"2018-02-01",2018,2,3,4
"경기",1313,"2018-02-01",2018,2,802,511
"강원",282,"2018-02-01",2018,2,189,93
"충북",185,"2018-02-01",2018,2,113,72
"충남",313,"2018-02-01",2018,2,225,88
"전북",258,"2018-02-01",2018,2,161,97
"전남",248,"2018-02-01",2018,2,162,86
"경북",397,"2018-02-01",2018,2,294,103
"경남",641,"2018-02-01",2018,2,513,128
"제주",495,"2018-02-01",2018,2,455,40
"서울",502,"2018-03-01",2018,3,213,289
"부산",387,"2018-03-01",2018,3,243,144
"대구",238,"2018-03-01",2018,3,100,138
"인천",407,"2018-03-01",2018,3,194,213
"광주",131,"2018-03-01",2018,3,56,75
"대전",258,"2018-03-01",2018,3,71,187
"울산",153,"2018-03-01",2018,3,79,74
"세종",35,"2018-03-01",2018,3,23,12
"경기",1717,"2018-03-01",2018,3,968,749
"강원",378,"2018-03-01",2018,3,267,111
"충북",244,"2018-03-01",2018,3,145,99
"충남",496,"2018-03-01",2018,3,327,169
"전북",516,"2018-03-01",2018,3,333,183
"전남",370,"2018-03-01",2018,3,248,122
"경북",560,"2018-03-01",2018,3,405,155
"경남",726,"2018-03-01",2018,3,587,139
"제주",571,"2018-03-01",2018,3,512,59
"서울",472,"2018-04-01",2018,4,147,325
"부산",367,"2018-04-01",2018,4,209,158
"대구",226,"2018-04-01",2018,4,117,109
"인천",377,"2018-04-01",2018,4,164,213
"광주",152,"2018-04-01",2018,4,63,89
"대전",259,"2018-04-01",2018,4,77,182
"울산",134,"2018-04-01",2018,4,62,72
"세종",24,"2018-04-01",2018,4,16,8
"경기",1629,"2018-04-01",2018,4,817,812
"강원",379,"2018-04-01",2018,4,230,149
"충북",216,"2018-04-01",2018,4,121,95
"충남",458,"2018-04-01",2018,4,301,157
"전북",423,"2018-04-01",2018,4,262,161
"전남",369,"2018-04-01",2018,4,231,138
"경북",554,"2018-04-01",2018,4,417,137
"경남",993,"2018-04-01",2018,4,797,196
"제주",524,"2018-04-01",2018,4,468,56
"서울",538,"2018-05-01",2018,5,183,355
"부산",349,"2018-05-01",2018,5,187,162
"대구",237,"2018-05-01",2018,5,128,109
"인천",487,"2018-05-01",2018,5,211,276
"광주",147,"2018-05-01",2018,5,80,67
"대전",274,"2018-05-01",2018,5,99,175
"울산",154,"2018-05-01",2018,5,73,81
"세종",23,"2018-05-01",2018,5,17,6
"경기",1708,"2018-05-01",2018,5,956,752
"강원",362,"2018-05-01",2018,5,226,136
"충북",312,"2018-05-01",2018,5,150,162
"충남",503,"2018-05-01",2018,5,342,161
"전북",447,"2018-05-01",2018,5,290,157
"전남",403,"2018-05-01",2018,5,284,119
"경북",545,"2018-05-01",2018,5,384,161
"경남",1014,"2018-05-01",2018,5,769,245
"제주",568,"2018-05-01",2018,5,486,82
"서울",507,"2018-06-01",2018,6,164,343
"부산",371,"2018-06-01",2018,6,191,180
"대구",239,"2018-06-01",2018,6,109,130
"인천",405,"2018-06-01",2018,6,146,259
"광주",152,"2018-06-01",2018,6,59,93
"대전",307,"2018-06-01",2018,6,80,227
"울산",146,"2018-06-01",2018,6,64,82
"세종",19,"2018-06-01",2018,6,4,15
"경기",1653,"2018-06-01",2018,6,811,842
"강원",343,"2018-06-01",2018,6,188,155
"충북",254,"2018-06-01",2018,6,127,127
"충남",393,"2018-06-01",2018,6,241,152
"전북",420,"2018-06-01",2018,6,280,140
"전남",326,"2018-06-01",2018,6,199,127
"경북",538,"2018-06-01",2018,6,412,126
"경남",852,"2018-06-01",2018,6,629,223
"제주",485,"2018-06-01",2018,6,436,49
"서울",487,"2018-07-01",2018,7,146,341
"부산",436,"2018-07-01",2018,7,233,203
"대구",249,"2018-07-01",2018,7,124,125
"인천",456,"2018-07-01",2018,7,173,283
"광주",166,"2018-07-01",2018,7,81,85
"대전",280,"2018-07-01",2018,7,76,204
"울산",154,"2018-07-01",2018,7,84,70
"세종",29,"2018-07-01",2018,7,18,11
"경기",1946,"2018-07-01",2018,7,970,976
"강원",421,"2018-07-01",2018,7,262,159
"충북",260,"2018-07-01",2018,7,136,124
"충남",416,"2018-07-01",2018,7,271,145
"전북",519,"2018-07-01",2018,7,342,177
"전남",419,"2018-07-01",2018,7,303,116
"경북",605,"2018-07-01",2018,7,440,165
"경남",962,"2018-07-01",2018,7,760,202
"제주",520,"2018-07-01",2018,7,467,53
"서울",501,"2018-08-01",2018,8,139,362
"부산",430,"2018-08-01",2018,8,228,202
"대구",248,"2018-08-01",2018,8,124,124
"인천",430,"2018-08-01",2018,8,183,247
"광주",182,"2018-08-01",2018,8,83,99
"대전",326,"2018-08-01",2018,8,88,238
"울산",167,"2018-08-01",2018,8,88,79
"세종",29,"2018-08-01",2018,8,15,14
"경기",1866,"2018-08-01",2018,8,1003,863
"강원",454,"2018-08-01",2018,8,304,150
"충북",308,"2018-08-01",2018,8,154,154
"충남",452,"2018-08-01",2018,8,279,173
"전북",446,"2018-08-01",2018,8,313,133
"전남",406,"2018-08-01",2018,8,300,106
"경북",667,"2018-08-01",2018,8,527,140
"경남",1051,"2018-08-01",2018,8,823,228
"제주",500,"2018-08-01",2018,8,443,57
"서울",444,"2018-09-01",2018,9,143,301
"부산",351,"2018-09-01",2018,9,196,155
"대구",257,"2018-09-01",2018,9,131,126
"인천",418,"2018-09-01",2018,9,197,221
"광주",151,"2018-09-01",2018,9,84,67
"대전",293,"2018-09-01",2018,9,94,199
"울산",158,"2018-09-01",2018,9,76,82
"세종",23,"2018-09-01",2018,9,16,7
"경기",1799,"2018-09-01",2018,9,1008,791
"강원",410,"2018-09-01",2018,9,266,144
"충북",316,"2018-09-01",2018,9,178,138
"충남",489,"2018-09-01",2018,9,324,165
"전북",475,"2018-09-01",2018,9,317,158
"전남",471,"2018-09-01",2018,9,352,119
"경북",515,"2018-09-01",2018,9,378,137
"경남",922,"2018-09-01",2018,9,751,171
"제주",527,"2018-09-01",2018,9,488,39
"서울",450,"2018-10-01",2018,10,166,284
"부산",420,"2018-10-01",2018,10,256,164
"대구",259,"2018-10-01",2018,10,151,108
"인천",374,"2018-10-01",2018,10,149,225
"광주",149,"2018-10-01",2018,10,69,80
"대전",283,"2018-10-01",2018,10,76,207
"울산",134,"2018-10-01",2018,10,70,64
"세종",30,"2018-10-01",2018,10,17,13
"경기",1861,"2018-10-01",2018,10,1085,776
"강원",394,"2018-10-01",2018,10,266,128
"충북",306,"2018-10-01",2018,10,167,139
"충남",514,"2018-10-01",2018,10,364,150
"전북",537,"2018-10-01",2018,10,349,188
"전남",397,"2018-10-01",2018,10,274,123
"경북",545,"2018-10-01",2018,10,416,129
"경남",994,"2018-10-01",2018,10,799,195
"제주",619,"2018-10-01",2018,10,564,55
"서울",437,"2018-11-01",2018,11,194,243
"부산",354,"2018-11-01",2018,11,213,141
"대구",239,"2018-11-01",2018,11,144,95
"인천",342,"2018-11-01",2018,11,174,168
"광주",122,"2018-11-01",2018,11,67,55
"대전",234,"2018-11-01",2018,11,87,147
"울산",128,"2018-11-01",2018,11,74,54
"세종",17,"2018-11-01",2018,11,10,7
"경기",1549,"2018-11-01",2018,11,945,604
"강원",463,"2018-11-01",2018,11,319,144
"충북",307,"2018-11-01",2018,11,195,112
"충남",889,"2018-11-01",2018,11,668,221
"전북",485,"2018-11-01",2018,11,368,117
"전남",429,"2018-11-01",2018,11,315,114
"경북",483,"2018-11-01",2018,11,361,122
"경남",835,"2018-11-01",2018,11,663,172
"제주",531,"2018-11-01",2018,11,481,50
"서울",289,"2018-12-01",2018,12,126,163
"부산",319,"2018-12-01",2018,12,183,136
"대구",199,"2018-12-01",2018,12,108,91
"인천",271,"2018-12-01",2018,12,144,127
"광주",142,"2018-12-01",2018,12,76,66
"대전",168,"2018-12-01",2018,12,76,92
"울산",108,"2018-12-01",2018,12,55,53
"세종",37,"2018-12-01",2018,12,16,21
"경기",1328,"2018-12-01",2018,12,820,508
"강원",431,"2018-12-01",2018,12,298,133
"충북",310,"2018-12-01",2018,12,221,89
"충남",481,"2018-12-01",2018,12,351,130
"전북",374,"2018-12-01",2018,12,268,106
"전남",343,"2018-12-01",2018,12,247,96
"경북",551,"2018-12-01",2018,12,440,111
"경남",756,"2018-12-01",2018,12,612,144
"제주",527,"2018-12-01",2018,12,484,43
"서울",336,"2019-01-01",2019,1,141,195
"부산",345,"2019-01-01",2019,1,241,104
"대구",210,"2019-01-01",2019,1,139,71
"인천",314,"2019-01-01",2019,1,177,137
"광주",174,"2019-01-01",2019,1,120,54
"대전",343,"2019-01-01",2019,1,167,176
"울산",126,"2019-01-01",2019,1,72,54
"세종",26,"2019-01-01",2019,1,22,4
"경기",1694,"2019-01-01",2019,1,1164,530
"강원",409,"2019-01-01",2019,1,299,110
"충북",317,"2019-01-01",2019,1,217,100
"충남",546,"2019-01-01",2019,1,412,134
"전북",542,"2019-01-01",2019,1,413,129
"전남",503,"2019-01-01",2019,1,380,123
"경북",536,"2019-01-01",2019,1,419,117
"경남",1091,"2019-01-01",2019,1,934,157
"제주",626,"2019-01-01",2019,1,586,40
"서울",302,"2019-02-01",2019,2,131,171
"부산",294,"2019-02-01",2019,2,180,114
"대구",217,"2019-02-01",2019,2,129,88
"인천",312,"2019-02-01",2019,2,183,129
"광주",137,"2019-02-01",2019,2,74,63
"대전",198,"2019-02-01",2019,2,88,110
"울산",121,"2019-02-01",2019,2,77,44
"세종",20,"2019-02-01",2019,2,13,7
"경기",1404,"2019-02-01",2019,2,917,487
"강원",387,"2019-02-01",2019,2,274,113
"충북",273,"2019-02-01",2019,2,195,78
"충남",426,"2019-02-01",2019,2,313,113
"전북",465,"2019-02-01",2019,2,339,126
"전남",459,"2019-02-01",2019,2,363,96
"경북",537,"2019-02-01",2019,2,446,91
"경남",1012,"2019-02-01",2019,2,830,182
"제주",454,"2019-02-01",2019,2,418,36
"서울",370,"2019-03-01",2019,3,143,227
"부산",347,"2019-03-01",2019,3,215,132
"대구",236,"2019-03-01",2019,3,146,90
"인천",361,"2019-03-01",2019,3,211,150
"광주",143,"2019-03-01",2019,3,73,70
"대전",254,"2019-03-01",2019,3,83,171
"울산",126,"2019-03-01",2019,3,74,52
"세종",35,"2019-03-01",2019,3,19,16
"경기",1654,"2019-03-01",2019,3,1059,595
"강원",382,"2019-03-01",2019,3,279,103
"충북",293,"2019-03-01",2019,3,179,114
"충남",519,"2019-03-01",2019,3,354,165
"전북",538,"2019-03-01",2019,3,411,127
"전남",571,"2019-03-01",2019,3,462,109
"경북",759,"2019-03-01",2019,3,619,140
"경남",1032,"2019-03-01",2019,3,888,144
"제주",553,"2019-03-01",2019,3,507,46
"서울",385,"2019-04-01",2019,4,160,225
"부산",373,"2019-04-01",2019,4,219,154
"대구",236,"2019-04-01",2019,4,143,93
"인천",354,"2019-04-01",2019,4,189,165
"광주",190,"2019-04-01",2019,4,109,81
"대전",222,"2019-04-01",2019,4,83,139
"울산",148,"2019-04-01",2019,4,90,58
"세종",27,"2019-04-01",2019,4,14,13
"경기",1911,"2019-04-01",2019,4,1244,667
"강원",438,"2019-04-01",2019,4,316,122
"충북",355,"2019-04-01",2019,4,243,112
"충남",528,"2019-04-01",2019,4,404,124
"전북",524,"2019-04-01",2019,4,394,130
"전남",554,"2019-04-01",2019,4,443,111
"경북",677,"2019-04-01",2019,4,530,147
"경남",1042,"2019-04-01",2019,4,879,163
"제주",582,"2019-04-01",2019,4,544,38
"서울",432,"2019-05-01",2019,5,157,275
"부산",343,"2019-05-01",2019,5,185,158
"대구",252,"2019-05-01",2019,5,129,123
"인천",383,"2019-05-01",2019,5,199,184
"광주",164,"2019-05-01",2019,5,84,80
"대전",244,"2019-05-01",2019,5,89,155
"울산",118,"2019-05-01",2019,5,69,49
"세종",30,"2019-05-01",2019,5,20,10
"경기",1786,"2019-05-01",2019,5,1083,703
"강원",488,"2019-05-01",2019,5,345,143
"충북",292,"2019-05-01",2019,5,180,112
"충남",507,"2019-05-01",2019,5,360,147
"전북",517,"2019-05-01",2019,5,392,125
"전남",511,"2019-05-01",2019,5,400,111
"경북",594,"2019-05-01",2019,5,472,122
"경남",1008,"2019-05-01",2019,5,793,215
"제주",511,"2019-05-01",2019,5,463,48
"서울",359,"2019-06-01",2019,6,125,234
"부산",350,"2019-06-01",2019,6,196,154
"대구",221,"2019-06-01",2019,6,111,110
"인천",355,"2019-06-01",2019,6,169,186
"광주",199,"2019-06-01",2019,6,119,80
"대전",202,"2019-06-01",2019,6,67,135
"울산",133,"2019-06-01",2019,6,68,65
"세종",21,"2019-06-01",2019,6,9,12
"경기",1537,"2019-06-01",2019,6,949,588
"강원",419,"2019-06-01",2019,6,291,128
"충북",391,"2019-06-01",2019,6,252,139
"충남",514,"2019-06-01",2019,6,362,152
"전북",489,"2019-06-01",2019,6,364,125
"전남",485,"2019-06-01",2019,6,361,124
"경북",581,"2019-06-01",2019,6,458,123
"경남",907,"2019-06-01",2019,6,738,169
"제주",594,"2019-06-01",2019,6,559,35
"서울",466,"2019-07-01",2019,7,172,294
"부산",418,"2019-07-01",2019,7,235,183
"대구",273,"2019-07-01",2019,7,155,118
"인천",485,"2019-07-01",2019,7,264,221
"광주",231,"2019-07-01",2019,7,133,98
"대전",221,"2019-07-01",2019,7,85,136
"울산",124,"2019-07-01",2019,7,59,65
"세종",35,"2019-07-01",2019,7,19,16
"경기",2158,"2019-07-01",2019,7,1352,806
"강원",550,"2019-07-01",2019,7,390,160
"충북",358,"2019-07-01",2019,7,219,139
"충남",787,"2019-07-01",2019,7,589,198
"전북",633,"2019-07-01",2019,7,465,168
"전남",633,"2019-07-01",2019,7,492,141
"경북",838,"2019-07-01",2019,7,672,166
"경남",1226,"2019-07-01",2019,7,996,230
"제주",623,"2019-07-01",2019,7,564,59
"서울",474,"2019-08-01",2019,8,174,300
"부산",423,"2019-08-01",2019,8,240,183
"대구",260,"2019-08-01",2019,8,158,102
"인천",391,"2019-08-01",2019,8,199,192
"광주",163,"2019-08-01",2019,8,78,85
"대전",250,"2019-08-01",2019,8,111,139
"울산",175,"2019-08-01",2019,8,93,82
"세종",45,"2019-08-01",2019,8,25,20
"경기",2181,"2019-08-01",2019,8,1417,764
"강원",545,"2019-08-01",2019,8,391,154
"충북",408,"2019-08-01",2019,8,270,138
"충남",632,"2019-08-01",2019,8,494,138
"전북",640,"2019-08-01",2019,8,501,139
"전남",601,"2019-08-01",2019,8,483,118
"경북",769,"2019-08-01",2019,8,612,157
"경남",1209,"2019-08-01",2019,8,1002,207
"제주",640,"2019-08-01",2019,8,588,52
"서울",390,"2019-09-01",2019,9,136,254
"부산",397,"2019-09-01",2019,9,249,148
"대구",249,"2019-09-01",2019,9,132,117
"인천",389,"2019-09-01",2019,9,214,175
"광주",209,"2019-09-01",2019,9,126,83
"대전",226,"2019-09-01",2019,9,99,127
"울산",144,"2019-09-01",2019,9,83,61
"세종",15,"2019-09-01",2019,9,13,2
"경기",1973,"2019-09-01",2019,9,1317,656
"강원",505,"2019-09-01",2019,9,365,140
"충북",397,"2019-09-01",2019,9,244,153
"충남",640,"2019-09-01",2019,9,467,173
"전북",474,"2019-09-01",2019,9,363,111
"전남",611,"2019-09-01",2019,9,466,145
"경북",794,"2019-09-01",2019,9,654,140
"경남",1292,"2019-09-01",2019,9,1111,181
"제주",642,"2019-09-01",2019,9,598,44
"서울",392,"2019-10-01",2019,10,162,230
"부산",344,"2019-10-01",2019,10,189,155
"대구",238,"2019-10-01",2019,10,152,86
"인천",379,"2019-10-01",2019,10,200,179
"광주",212,"2019-10-01",2019,10,121,91
"대전",218,"2019-10-01",2019,10,87,131
"울산",158,"2019-10-01",2019,10,108,50
"세종",48,"2019-10-01",2019,10,35,13
"경기",1876,"2019-10-01",2019,10,1266,610
"강원",437,"2019-10-01",2019,10,296,141
"충북",304,"2019-10-01",2019,10,185,119
"충남",547,"2019-10-01",2019,10,419,128
"전북",558,"2019-10-01",2019,10,461,97
"전남",596,"2019-10-01",2019,10,483,113
"경북",812,"2019-10-01",2019,10,684,128
"경남",1191,"2019-10-01",2019,10,1029,162
"제주",598,"2019-10-01",2019,10,548,50
"서울",297,"2019-11-01",2019,11,131,166
"부산",284,"2019-11-01",2019,11,187,97
"대구",223,"2019-11-01",2019,11,137,86
"인천",293,"2019-11-01",2019,11,161,132
"광주",161,"2019-11-01",2019,11,91,70
"대전",198,"2019-11-01",2019,11,97,101
"울산",139,"2019-11-01",2019,11,89,50
"세종",20,"2019-11-01",2019,11,10,10
"경기",1645,"2019-11-01",2019,11,1151,494
"강원",386,"2019-11-01",2019,11,288,98
"충북",276,"2019-11-01",2019,11,195,81
"충남",506,"2019-11-01",2019,11,380,126
"전북",511,"2019-11-01",2019,11,391,120
"전남",577,"2019-11-01",2019,11,479,98
"경북",670,"2019-11-01",2019,11,539,131
"경남",861,"2019-11-01",2019,11,728,133
"제주",532,"2019-11-01",2019,11,484,48
"서울",314,"2019-12-01",2019,12,161,153
"부산",289,"2019-12-01",2019,12,193,96
"대구",220,"2019-12-01",2019,12,120,100
"인천",290,"2019-12-01",2019,12,171,119
"광주",162,"2019-12-01",2019,12,95,67
"대전",178,"2019-12-01",2019,12,89,89
"울산",140,"2019-12-01",2019,12,93,47
"세종",27,"2019-12-01",2019,12,23,4
"경기",1389,"2019-12-01",2019,12,986,403
"강원",336,"2019-12-01",2019,12,247,89
"충북",337,"2019-12-01",2019,12,250,87
"충남",565,"2019-12-01",2019,12,429,136
"전북",409,"2019-12-01",2019,12,333,76
"전남",660,"2019-12-01",2019,12,561,99
"경북",619,"2019-12-01",2019,12,513,106
"경남",1083,"2019-12-01",2019,12,925,158
"제주",498,"2019-12-01",2019,12,456,42
"서울",277,"2020-01-01",2020,1,113,164
"부산",282,"2020-01-01",2020,1,177,105
"대구",216,"2020-01-01",2020,1,138,78
"인천",321,"2020-01-01",2020,1,212,109
"광주",152,"2020-01-01",2020,1,87,65
"대전",166,"2020-01-01",2020,1,91,75
"울산",183,"2020-01-01",2020,1,134,49
"세종",35,"2020-01-01",2020,1,30,5
"경기",2084,"2020-01-01",2020,1,1570,514
"강원",401,"2020-01-01",2020,1,311,90
"충북",363,"2020-01-01",2020,1,280,83
"충남",631,"2020-01-01",2020,1,510,121
"전북",620,"2020-01-01",2020,1,498,122
"전남",651,"2020-01-01",2020,1,556,95
"경북",751,"2020-01-01",2020,1,631,120
"경남",1009,"2020-01-01",2020,1,887,122
"제주",603,"2020-01-01",2020,1,558,45
"서울",282,"2020-02-01",2020,2,127,155
"부산",309,"2020-02-01",2020,2,201,108
"대구",157,"2020-02-01",2020,2,101,56
"인천",337,"2020-02-01",2020,2,209,128
"광주",155,"2020-02-01",2020,2,107,48
"대전",154,"2020-02-01",2020,2,92,62
"울산",122,"2020-02-01",2020,2,68,54
"세종",14,"2020-02-01",2020,2,10,4
"경기",1780,"2020-02-01",2020,2,1354,426
"강원",404,"2020-02-01",2020,2,309,95
"충북",323,"2020-02-01",2020,2,248,75
"충남",549,"2020-02-01",2020,2,453,96
"전북",616,"2020-02-01",2020,2,514,102
"전남",702,"2020-02-01",2020,2,612,90
"경북",700,"2020-02-01",2020,2,583,117
"경남",997,"2020-02-01",2020,2,869,128
"제주",525,"2020-02-01",2020,2,482,43
"서울",337,"2020-03-01",2020,3,160,177
"부산",323,"2020-03-01",2020,3,211,112
"대구",182,"2020-03-01",2020,3,119,63
"인천",380,"2020-03-01",2020,3,252,128
"광주",148,"2020-03-01",2020,3,93,55
"대전",177,"2020-03-01",2020,3,91,86
"울산",134,"2020-03-01",2020,3,109,25
"세종",16,"2020-03-01",2020,3,12,4
"경기",1832,"2020-03-01",2020,3,1295,537
"강원",425,"2020-03-01",2020,3,338,87
"충북",375,"2020-03-01",2020,3,291,84
"충남",653,"2020-03-01",2020,3,527,126
"전북",688,"2020-03-01",2020,3,575,113
"전남",777,"2020-03-01",2020,3,687,90
"경북",781,"2020-03-01",2020,3,632,149
"경남",1111,"2020-03-01",2020,3,966,145
"제주",504,"2020-03-01",2020,3,464,40
"서울",266,"2020-04-01",2020,4,121,145
"부산",292,"2020-04-01",2020,4,186,106
"대구",186,"2020-04-01",2020,4,129,57
"인천",289,"2020-04-01",2020,4,172,117
"광주",121,"2020-04-01",2020,4,73,48
"대전",129,"2020-04-01",2020,4,67,62
"울산",138,"2020-04-01",2020,4,97,41
"세종",22,"2020-04-01",2020,4,14,8
"경기",1518,"2020-04-01",2020,4,1045,473
"강원",338,"2020-04-01",2020,4,266,72
"충북",241,"2020-04-01",2020,4,173,68
"충남",568,"2020-04-01",2020,4,480,88
"전북",588,"2020-04-01",2020,4,483,105
"전남",628,"2020-04-01",2020,4,536,92
"경북",697,"2020-04-01",2020,4,592,105
"경남",1050,"2020-04-01",2020,4,919,131
"제주",561,"2020-04-01",2020,4,520,41
"서울",318,"2020-05-01",2020,5,130,188
"부산",250,"2020-05-01",2020,5,134,116
"대구",189,"2020-05-01",2020,5,119,70
"인천",331,"2020-05-01",2020,5,202,129
"광주",176,"2020-05-01",2020,5,85,91
"대전",165,"2020-05-01",2020,5,79,86
"울산",139,"2020-05-01",2020,5,101,38
"세종",20,"2020-05-01",2020,5,11,9
"경기",1732,"2020-05-01",2020,5,1188,544
"강원",397,"2020-05-01",2020,5,317,80
"충북",315,"2020-05-01",2020,5,226,89
"충남",618,"2020-05-01",2020,5,508,110
"전북",552,"2020-05-01",2020,5,449,103
"전남",623,"2020-05-01",2020,5,530,93
"경북",632,"2020-05-01",2020,5,519,113
"경남",997,"2020-05-01",2020,5,845,152
"제주",446,"2020-05-01",2020,5,411,35
"서울",304,"2020-06-01",2020,6,119,185
"부산",350,"2020-06-01",2020,6,227,123
"대구",199,"2020-06-01",2020,6,108,91
"인천",304,"2020-06-01",2020,6,169,135
"광주",145,"2020-06-01",2020,6,86,59
"대전",161,"2020-06-01",2020,6,69,92
"울산",129,"2020-06-01",2020,6,82,47
"세종",8,"2020-06-01",2020,6,3,5
"경기",1660,"2020-06-01",2020,6,1137,523
"강원",364,"2020-06-01",2020,6,278,86
"충북",297,"2020-06-01",2020,6,201,96
"충남",555,"2020-06-01",2020,6,429,126
"전북",487,"2020-06-01",2020,6,376,111
"전남",544,"2020-06-01",2020,6,450,94
"경북",690,"2020-06-01",2020,6,563,127
"경남",1060,"2020-06-01",2020,6,904,156
"제주",425,"2020-06-01",2020,6,389,36
"서울",337,"2020-07-01",2020,7,142,195
"부산",349,"2020-07-01",2020,7,229,120
"대구",193,"2020-07-01",2020,7,119,74
"인천",379,"2020-07-01",2020,7,233,146
"광주",193,"2020-07-01",2020,7,119,74
"대전",181,"2020-07-01",2020,7,76,105
"울산",162,"2020-07-01",2020,7,123,39
"세종",0,"2020-07-01",2020,7,0,0
"경기",1793,"2020-07-01",2020,7,1208,585
"강원",402,"2020-07-01",2020,7,293,109
"충북",315,"2020-07-01",2020,7,233,82
"충남",695,"2020-07-01",2020,7,602,93
"전북",677,"2020-07-01",2020,7,538,139
"전남",748,"2020-07-01",2020,7,633,115
"경북",722,"2020-07-01",2020,7,604,118
"경남",1203,"2020-07-01",2020,7,1028,175
"제주",512,"2020-07-01",2020,7,470,42
"서울",332,"2020-08-01",2020,8,143,189
"부산",369,"2020-08-01",2020,8,259,110
"대구",218,"2020-08-01",2020,8,131,87
"인천",346,"2020-08-01",2020,8,190,156
"광주",171,"2020-08-01",2020,8,112,59
"대전",182,"2020-08-01",2020,8,86,96
"울산",139,"2020-08-01",2020,8,85,54
"세종",35,"2020-08-01",2020,8,29,6
"경기",1928,"2020-08-01",2020,8,1309,619
"강원",462,"2020-08-01",2020,8,364,98
"충북",460,"2020-08-01",2020,8,328,132
"충남",679,"2020-08-01",2020,8,558,121
"전북",587,"2020-08-01",2020,8,452,135
"전남",583,"2020-08-01",2020,8,478,105
"경북",712,"2020-08-01",2020,8,604,108
"경남",1079,"2020-08-01",2020,8,920,159
"제주",412,"2020-08-01",2020,8,371,41
"서울",280,"2020-09-01",2020,9,120,160
"부산",279,"2020-09-01",2020,9,173,106
"대구",201,"2020-09-01",2020,9,117,84
"인천",297,"2020-09-01",2020,9,186,111
"광주",159,"2020-09-01",2020,9,105,54
"대전",151,"2020-09-01",2020,9,69,82
"울산",139,"2020-09-01",2020,9,92,47
"세종",32,"2020-09-01",2020,9,28,4
"경기",1639,"2020-09-01",2020,9,1150,489
"강원",389,"2020-09-01",2020,9,304,85
"충북",318,"2020-09-01",2020,9,223,95
"충남",605,"2020-09-01",2020,9,496,109
"전북",508,"2020-09-01",2020,9,404,104
"전남",603,"2020-09-01",2020,9,502,101
"경북",712,"2020-09-01",2020,9,614,98
"경남",979,"2020-09-01",2020,9,858,121
"제주",486,"2020-09-01",2020,9,449,37
"서울",279,"2020-10-01",2020,10,129,150
"부산",285,"2020-10-01",2020,10,191,94
"대구",182,"2020-10-01",2020,10,97,85
"인천",213,"2020-10-01",2020,10,129,84
"광주",110,"2020-10-01",2020,10,55,55
"대전",122,"2020-10-01",2020,10,58,64
"울산",133,"2020-10-01",2020,10,90,43
"세종",24,"2020-10-01",2020,10,21,3
"경기",1571,"2020-10-01",2020,10,1119,452
"강원",356,"2020-10-01",2020,10,254,102
"충북",249,"2020-10-01",2020,10,181,68
"충남",505,"2020-10-01",2020,10,401,104
"전북",459,"2020-10-01",2020,10,378,81
"전남",574,"2020-10-01",2020,10,483,91
"경북",614,"2020-10-01",2020,10,519,95
"경남",961,"2020-10-01",2020,10,821,140
"제주",513,"2020-10-01",2020,10,478,35
"서울",205,"2020-11-01",2020,11,97,108
"부산",234,"2020-11-01",2020,11,152,82
"대구",166,"2020-11-01",2020,11,105,61
"인천",241,"2020-11-01",2020,11,134,107
"광주",111,"2020-11-01",2020,11,61,50
"대전",140,"2020-11-01",2020,11,74,66
"울산",116,"2020-11-01",2020,11,88,28
"세종",18,"2020-11-01",2020,11,13,5
"경기",1415,"2020-11-01",2020,11,1016,399
"강원",341,"2020-11-01",2020,11,265,76
"충북",228,"2020-11-01",2020,11,156,72
"충남",464,"2020-11-01",2020,11,379,85
"전북",492,"2020-11-01",2020,11,408,84
"전남",606,"2020-11-01",2020,11,528,78
"경북",691,"2020-11-01",2020,11,596,95
"경남",859,"2020-11-01",2020,11,757,102
"제주",385,"2020-11-01",2020,11,352,33
"서울",200,"2020-12-01",2020,12,96,104
"부산",217,"2020-12-01",2020,12,165,52
"대구",136,"2020-12-01",2020,12,84,52
"인천",337,"2020-12-01",2020,12,261,76
"광주",135,"2020-12-01",2020,12,87,48
"대전",111,"2020-12-01",2020,12,56,55
"울산",109,"2020-12-01",2020,12,80,29
"세종",37,"2020-12-01",2020,12,30,7
"경기",1239,"2020-12-01",2020,12,913,326
"강원",292,"2020-12-01",2020,12,235,57
"충북",262,"2020-12-01",2020,12,205,57
"충남",558,"2020-12-01",2020,12,475,83
"전북",456,"2020-12-01",2020,12,385,71
"전남",528,"2020-12-01",2020,12,457,71
"경북",608,"2020-12-01",2020,12,525,83
"경남",709,"2020-12-01",2020,12,622,87
"제주",347,"2020-12-01",2020,12,317,30
